version,votes_for,votes_against,votes_net,votes_total,votes_ratio,release_date
webview_ios_18.2.0,852,95,757,947,0.8996832101372756,2024-12-11
webview_ios_18.3.0,852,95,757,947,0.8996832101372756,UNKNOWN
webview_ios_18,849,98,751,947,0.8965153115100317,2024-09-16
webview_ios_18.1.0,849,98,751,947,0.8965153115100317,2024-10-28
webview_ios_17,847,100,747,947,0.8944033790918691,2023-09-18
webview_ios_17.1.0,847,100,747,947,0.8944033790918691,2023-10-25
webview_ios_17.5.0,847,100,747,947,0.8944033790918691,2024-05-13
webview_ios_17.6.0,847,100,747,947,0.8944033790918691,2024-07-29
webview_ios_17.4.0,846,101,745,947,0.8933474128827877,2024-03-05
webview_ios_17.2.0,845,102,743,947,0.8922914466737064,2023-12-11
webview_ios_17.3.0,845,102,743,947,0.8922914466737064,2024-01-22
webview_ios_16.4.0,844,103,741,947,0.8912354804646251,2023-03-27
webview_ios_16.5.0,844,103,741,947,0.8912354804646251,2023-05-18
webview_ios_16.6.0,844,103,741,947,0.8912354804646251,2023-07-24
safari_18.2.0,850,112,738,962,0.8835758835758836,2024-12-11
safari_18.3.0,850,112,738,962,0.8835758835758836,UNKNOWN
safari_18,847,115,732,962,0.8804573804573804,2024-09-16
safari_18.1.0,847,115,732,962,0.8804573804573804,2024-10-28
safari_ios_18.2.0,846,116,730,962,0.8794178794178794,2024-12-11
safari_ios_18.3.0,846,116,730,962,0.8794178794178794,UNKNOWN
safari_17,845,117,728,962,0.8783783783783784,2023-09-18
safari_17.1.0,845,117,728,962,0.8783783783783784,2023-10-25
safari_17.5.0,845,117,728,962,0.8783783783783784,2024-05-13
safari_17.6.0,845,117,728,962,0.8783783783783784,2024-07-29
safari_17.4.0,844,118,726,962,0.8773388773388774,2024-03-05
safari_17.2.0,843,119,724,962,0.8762993762993763,2023-12-11
safari_17.3.0,843,119,724,962,0.8762993762993763,2024-01-22
safari_ios_18,843,119,724,962,0.8762993762993763,2024-09-16
safari_ios_18.1.0,843,119,724,962,0.8762993762993763,2024-10-28
safari_16.4.0,841,121,720,962,0.8742203742203742,2023-03-27
safari_16.5.0,841,121,720,962,0.8742203742203742,2023-05-18
safari_16.6.0,841,121,720,962,0.8742203742203742,2023-07-24
safari_ios_17,841,121,720,962,0.8742203742203742,2023-09-18
safari_ios_17.1.0,841,121,720,962,0.8742203742203742,2023-10-25
safari_ios_17.5.0,841,121,720,962,0.8742203742203742,2024-05-13
safari_ios_17.6.0,841,121,720,962,0.8742203742203742,2024-07-29
safari_ios_17.4.0,840,122,718,962,0.8731808731808732,2024-03-05
safari_ios_17.2.0,839,123,716,962,0.8721413721413721,2023-12-11
safari_ios_17.3.0,839,123,716,962,0.8721413721413721,2024-01-22
safari_ios_16.4.0,838,124,714,962,0.8711018711018711,2023-03-27
safari_ios_16.5.0,838,124,714,962,0.8711018711018711,2023-05-18
safari_ios_16.6.0,838,124,714,962,0.8711018711018711,2023-07-24
webview_ios_16.2.0,800,147,653,947,0.8447729672650475,2022-12-13
webview_ios_16.3.0,800,147,653,947,0.8447729672650475,2023-01-23
webview_ios_16,799,148,651,947,0.8437170010559663,2022-09-12
webview_ios_16.1.0,799,148,651,947,0.8437170010559663,2022-10-24
webview_ios_15.4.0,797,150,647,947,0.8416050686378036,2022-03-14
webview_ios_15.5.0,797,150,647,947,0.8416050686378036,2022-05-16
webview_ios_15.6.0,797,150,647,947,0.8416050686378036,2022-07-20
safari_15.4.0,801,161,640,962,0.8326403326403327,2022-03-14
safari_15.5.0,801,161,640,962,0.8326403326403327,2022-05-16
safari_15.6.0,801,161,640,962,0.8326403326403327,2022-07-20
safari_ios_16.2.0,801,161,640,962,0.8326403326403327,2022-12-13
safari_ios_16.3.0,801,161,640,962,0.8326403326403327,2023-01-23
safari_ios_16,800,162,638,962,0.8316008316008316,2022-09-12
safari_ios_16.1.0,800,162,638,962,0.8316008316008316,2022-10-24
safari_ios_15.4.0,798,164,634,962,0.8295218295218295,2022-03-14
safari_ios_15.5.0,798,164,634,962,0.8295218295218295,2022-05-16
safari_ios_15.6.0,798,164,634,962,0.8295218295218295,2022-07-20
safari_16.2.0,796,166,630,962,0.8274428274428275,2022-12-13
safari_16.3.0,796,166,630,962,0.8274428274428275,2023-01-23
safari_16,795,167,628,962,0.8264033264033264,2022-09-12
safari_16.1.0,795,167,628,962,0.8264033264033264,2022-10-24
firefox_android_130,791,167,624,958,0.8256784968684759,2024-09-03
firefox_android_129,790,168,622,958,0.824634655532359,2024-08-06
firefox_android_131,790,168,622,958,0.824634655532359,2024-10-01
firefox_android_128,789,169,620,958,0.8235908141962421,2024-07-09
firefox_android_127,788,170,618,958,0.8225469728601252,2024-06-11
firefox_android_126,787,171,616,958,0.8215031315240083,2024-05-14
firefox_android_132,787,171,616,958,0.8215031315240083,2024-10-29
edge_121,788,174,614,962,0.8191268191268192,2024-01-25
edge_122,788,174,614,962,0.8191268191268192,2024-02-23
edge_123,788,174,614,962,0.8191268191268192,2024-03-22
edge_124,788,174,614,962,0.8191268191268192,2024-04-18
edge_125,788,174,614,962,0.8191268191268192,2024-05-17
edge_126,788,174,614,962,0.8191268191268192,2024-06-13
edge_127,788,174,614,962,0.8191268191268192,2024-07-25
edge_120,787,175,612,962,0.818087318087318,2023-12-07
firefox_android_113,784,174,610,958,0.8183716075156576,2023-05-09
firefox_android_125,784,174,610,958,0.8183716075156576,2024-04-16
firefox_android_133,784,174,610,958,0.8183716075156576,2024-11-26
firefox_android_134,784,174,610,958,0.8183716075156576,2025-01-07
firefox_android_135,784,174,610,958,0.8183716075156576,2025-02-04
firefox_android_136,784,174,610,958,0.8183716075156576,2025-03-04
edge_118,786,176,610,962,0.817047817047817,2023-10-13
edge_119,786,176,610,962,0.817047817047817,2023-11-02
edge_128,786,176,610,962,0.817047817047817,2024-08-22
edge_129,786,176,610,962,0.817047817047817,2024-09-19
edge_130,786,176,610,962,0.817047817047817,2024-10-17
edge_131,786,176,610,962,0.817047817047817,2024-11-14
edge_132,786,176,610,962,0.817047817047817,2025-01-16
edge_133,786,176,610,962,0.817047817047817,2025-02-06
edge_134,786,176,610,962,0.817047817047817,2025-03-06
chrome_121,786,176,610,962,0.817047817047817,2024-01-23
chrome_122,786,176,610,962,0.817047817047817,2024-02-20
chrome_123,786,176,610,962,0.817047817047817,2024-03-19
chrome_124,786,176,610,962,0.817047817047817,2024-04-16
chrome_125,786,176,610,962,0.817047817047817,2024-05-14
chrome_126,786,176,610,962,0.817047817047817,2024-06-11
chrome_127,786,176,610,962,0.817047817047817,2024-07-23
chrome_77,785,176,609,961,0.8168574401664932,2019-09-10
chrome_78,785,176,609,961,0.8168574401664932,2019-10-22
webview_ios_15.2.0,778,169,609,947,0.8215417106652587,2021-12-13
webview_ios_15.3.0,778,169,609,947,0.8215417106652587,2022-01-26
firefox_android_121,783,175,608,958,0.8173277661795407,2023-12-19
edge_86,785,177,608,962,0.816008316008316,2020-10-09
edge_117,785,177,608,962,0.816008316008316,2023-09-15
chrome_120,785,177,608,962,0.816008316008316,2023-12-05
firefox_android_120,782,176,606,958,0.8162839248434238,2023-11-21
firefox_android_122,782,176,606,958,0.8162839248434238,2024-01-23
firefox_android_123,782,176,606,958,0.8162839248434238,2024-02-20
firefox_android_124,782,176,606,958,0.8162839248434238,2024-03-19
firefox_130,782,176,606,958,0.8162839248434238,2024-09-03
edge_114,784,178,606,962,0.814968814968815,2023-06-02
edge_115,784,178,606,962,0.814968814968815,2023-07-21
edge_116,784,178,606,962,0.814968814968815,2023-08-21
chrome_118,784,178,606,962,0.814968814968815,2023-10-10
chrome_119,784,178,606,962,0.814968814968815,2023-10-31
chrome_128,784,178,606,962,0.814968814968815,2024-08-20
chrome_129,784,178,606,962,0.814968814968815,2024-09-17
chrome_130,784,178,606,962,0.814968814968815,2024-10-15
webview_android_120,783,178,605,961,0.8147762747138397,2023-12-05
webview_android_121,783,178,605,961,0.8147762747138397,2024-01-23
webview_android_122,783,178,605,961,0.8147762747138397,2024-02-20
webview_android_123,783,178,605,961,0.8147762747138397,2024-03-19
webview_android_124,783,178,605,961,0.8147762747138397,2024-04-16
webview_android_125,783,178,605,961,0.8147762747138397,2024-05-14
webview_android_126,783,178,605,961,0.8147762747138397,2024-06-11
webview_android_127,783,178,605,961,0.8147762747138397,2024-07-23
chrome_android_120,783,178,605,961,0.8147762747138397,2023-12-05
chrome_android_121,783,178,605,961,0.8147762747138397,2024-01-23
chrome_android_122,783,178,605,961,0.8147762747138397,2024-02-20
chrome_android_123,783,178,605,961,0.8147762747138397,2024-03-19
chrome_android_124,783,178,605,961,0.8147762747138397,2024-04-16
chrome_android_125,783,178,605,961,0.8147762747138397,2024-05-14
chrome_android_126,783,178,605,961,0.8147762747138397,2024-06-11
chrome_android_127,783,178,605,961,0.8147762747138397,2024-07-23
firefox_android_111,781,177,604,958,0.8152400835073069,2023-03-14
firefox_android_112,781,177,604,958,0.8152400835073069,2023-04-11
firefox_131,781,177,604,958,0.8152400835073069,2024-10-01
edge_111,783,179,604,962,0.8139293139293139,2023-03-13
edge_112,783,179,604,962,0.8139293139293139,2023-04-06
edge_113,783,179,604,962,0.8139293139293139,2023-05-05
chrome_86,783,179,604,962,0.8139293139293139,2020-10-20
chrome_117,783,179,604,962,0.8139293139293139,2023-09-12
webview_android_118,782,179,603,961,0.813735691987513,2023-10-10
webview_android_119,782,179,603,961,0.813735691987513,2023-10-31
webview_android_128,782,179,603,961,0.813735691987513,2024-08-20
webview_android_129,782,179,603,961,0.813735691987513,2024-09-17
webview_android_130,782,179,603,961,0.813735691987513,2024-10-15
opera_107,782,179,603,961,0.813735691987513,2024-02-07
opera_108,782,179,603,961,0.813735691987513,2024-03-05
opera_109,782,179,603,961,0.813735691987513,2024-03-27
opera_110,782,179,603,961,0.813735691987513,2024-05-14
opera_111,782,179,603,961,0.813735691987513,2024-06-12
opera_112,782,179,603,961,0.813735691987513,2024-07-11
opera_113,782,179,603,961,0.813735691987513,2024-08-22
chrome_android_118,782,179,603,961,0.813735691987513,2023-10-10
chrome_android_119,782,179,603,961,0.813735691987513,2023-10-31
chrome_android_128,782,179,603,961,0.813735691987513,2024-08-20
chrome_android_129,782,179,603,961,0.813735691987513,2024-09-17
chrome_android_130,782,179,603,961,0.813735691987513,2024-10-15
webview_ios_15.1.0,775,172,603,947,0.8183738120380147,2021-10-25
firefox_android_114,780,178,602,958,0.81419624217119,2023-06-06
firefox_android_115,780,178,602,958,0.81419624217119,2023-07-04
firefox_android_118,780,178,602,958,0.81419624217119,2023-09-26
firefox_android_119,780,178,602,958,0.81419624217119,2023-10-24
safari_15.2.0,782,180,602,962,0.8128898128898129,2021-12-13
safari_15.3.0,782,180,602,962,0.8128898128898129,2022-01-26
firefox_129,780,178,602,958,0.81419624217119,2024-08-06
chrome_android_77,781,179,602,960,0.8135416666666667,2019-09-10
chrome_android_78,781,179,602,960,0.8135416666666667,2019-10-22
edge_84,782,180,602,962,0.8128898128898129,2020-07-16
edge_85,782,180,602,962,0.8128898128898129,2020-08-27
chrome_114,782,180,602,962,0.8128898128898129,2023-05-30
chrome_115,782,180,602,962,0.8128898128898129,2023-07-18
chrome_116,782,180,602,962,0.8128898128898129,2023-08-15
webview_android_117,781,180,601,961,0.8126951092611863,2023-09-12
opera_106,781,180,601,961,0.8126951092611863,2023-12-19
chrome_android_117,781,180,601,961,0.8126951092611863,2023-09-12
chrome_75,781,180,601,961,0.8126951092611863,2019-06-04
chrome_76,781,180,601,961,0.8126951092611863,2019-07-30
webview_ios_15,774,173,601,947,0.8173178458289335,2021-09-20
firefox_android_110,779,179,600,958,0.8131524008350731,2023-02-14
firefox_android_117,779,179,600,958,0.8131524008350731,2023-08-29
opera_64,780,180,600,960,0.8125,2019-10-07
opera_65,780,180,600,960,0.8125,2019-11-13
firefox_128,779,179,600,958,0.8131524008350731,2024-07-09
chrome_111,781,181,600,962,0.8118503118503119,2023-03-07
chrome_112,781,181,600,962,0.8118503118503119,2023-04-04
chrome_113,781,181,600,962,0.8118503118503119,2023-05-02
chrome_131,781,181,600,962,0.8118503118503119,2024-11-12
chrome_132,781,181,600,962,0.8118503118503119,2025-01-14
chrome_133,781,181,600,962,0.8118503118503119,2025-02-04
chrome_134,781,181,600,962,0.8118503118503119,UNKNOWN
webview_android_114,780,181,599,961,0.8116545265348595,2023-05-30
webview_android_115,780,181,599,961,0.8116545265348595,2023-07-21
webview_android_116,780,181,599,961,0.8116545265348595,2023-08-15
opera_104,780,181,599,961,0.8116545265348595,2023-10-23
opera_105,780,181,599,961,0.8116545265348595,2023-11-14
opera_114,780,181,599,961,0.8116545265348595,2024-09-25
opera_115,780,181,599,961,0.8116545265348595,2024-11-27
chrome_android_114,780,181,599,961,0.8116545265348595,2023-05-30
chrome_android_115,780,181,599,961,0.8116545265348595,2023-07-21
chrome_android_116,780,181,599,961,0.8116545265348595,2023-08-15
firefox_android_108,778,180,598,958,0.8121085594989561,2022-12-13
firefox_android_109,778,180,598,958,0.8121085594989561,2023-01-17
firefox_android_116,778,180,598,958,0.8121085594989561,2023-08-01
firefox_127,778,180,598,958,0.8121085594989561,2024-06-11
firefox_132,778,180,598,958,0.8121085594989561,2024-10-29
edge_87,780,182,598,962,0.8108108108108109,2020-11-19
edge_88,780,182,598,962,0.8108108108108109,2021-01-21
edge_90,780,182,598,962,0.8108108108108109,2021-04-15
edge_91,780,182,598,962,0.8108108108108109,2021-05-27
edge_92,780,182,598,962,0.8108108108108109,2021-07-22
chrome_84,780,182,598,962,0.8108108108108109,2020-07-27
chrome_85,780,182,598,962,0.8108108108108109,2020-08-25
webview_android_86,779,182,597,961,0.8106139438085328,2020-10-20
webview_android_111,779,182,597,961,0.8106139438085328,2023-03-01
webview_android_112,779,182,597,961,0.8106139438085328,2023-04-04
webview_android_113,779,182,597,961,0.8106139438085328,2023-05-02
webview_android_131,779,182,597,961,0.8106139438085328,2024-11-12
webview_android_132,779,182,597,961,0.8106139438085328,2025-01-14
webview_android_133,779,182,597,961,0.8106139438085328,2025-02-04
webview_android_134,779,182,597,961,0.8106139438085328,UNKNOWN
opera_103,779,182,597,961,0.8106139438085328,2023-10-03
chrome_android_111,779,182,597,961,0.8106139438085328,2023-03-07
chrome_android_112,779,182,597,961,0.8106139438085328,2023-04-04
chrome_android_113,779,182,597,961,0.8106139438085328,2023-05-02
chrome_android_131,779,182,597,961,0.8106139438085328,2024-11-12
chrome_android_132,779,182,597,961,0.8106139438085328,2025-01-14
chrome_android_133,779,182,597,961,0.8106139438085328,2025-02-04
chrome_android_134,779,182,597,961,0.8106139438085328,UNKNOWN
chrome_74,779,182,597,961,0.8106139438085328,2019-04-23
firefox_android_107,777,181,596,958,0.8110647181628392,2022-11-15
safari_15,779,183,596,962,0.8097713097713097,2021-09-20
safari_15.1.0,779,183,596,962,0.8097713097713097,2021-10-25
firefox_126,777,181,596,958,0.8110647181628392,2024-05-14
safari_ios_15.2.0,779,183,596,962,0.8097713097713097,2021-12-13
safari_ios_15.3.0,779,183,596,962,0.8097713097713097,2022-01-26
chrome_android_75,778,182,596,960,0.8104166666666667,2019-06-04
edge_81,779,183,596,962,0.8097713097713097,2020-04-13
chrome_109,779,183,596,962,0.8097713097713097,2023-01-10
chrome_110,779,183,596,962,0.8097713097713097,2023-02-07
webview_android_84,778,183,595,961,0.809573361082206,2020-07-27
webview_android_85,778,183,595,961,0.809573361082206,2020-08-25
opera_72,778,183,595,961,0.809573361082206,2020-10-21
opera_100,778,183,595,961,0.809573361082206,2023-06-29
opera_101,778,183,595,961,0.809573361082206,2023-07-26
opera_102,778,183,595,961,0.809573361082206,2023-08-23
chrome_android_86,778,183,595,961,0.809573361082206,2020-10-20
chrome_72,778,183,595,961,0.809573361082206,2019-01-29
firefox_android_105,776,182,594,958,0.8100208768267223,2022-09-20
firefox_android_106,776,182,594,958,0.8100208768267223,2022-10-18
opera_62,777,183,594,960,0.809375,2019-06-27
opera_63,777,183,594,960,0.809375,2019-08-20
chrome_android_76,777,183,594,960,0.809375,2019-07-30
edge_80,778,184,594,962,0.8087318087318087,2020-02-07
edge_109,778,184,594,962,0.8087318087318087,2023-01-12
edge_110,778,184,594,962,0.8087318087318087,2023-02-09
chrome_87,778,184,594,962,0.8087318087318087,2020-11-17
chrome_88,778,184,594,962,0.8087318087318087,2021-01-19
chrome_90,778,184,594,962,0.8087318087318087,2021-04-13
chrome_91,778,184,594,962,0.8087318087318087,2021-05-25
chrome_92,778,184,594,962,0.8087318087318087,2021-07-20
chrome_108,778,184,594,962,0.8087318087318087,2022-11-29
webview_android_109,777,184,593,961,0.8085327783558793,2023-01-10
webview_android_110,777,184,593,961,0.8085327783558793,2023-02-07
opera_97,777,184,593,961,0.8085327783558793,2023-03-22
opera_98,777,184,593,961,0.8085327783558793,2023-04-20
opera_99,777,184,593,961,0.8085327783558793,2023-05-16
opera_116,777,184,593,961,0.8085327783558793,UNKNOWN
opera_117,777,184,593,961,0.8085327783558793,UNKNOWN
chrome_android_84,777,184,593,961,0.8085327783558793,2020-07-27
chrome_android_85,777,184,593,961,0.8085327783558793,2020-08-25
chrome_android_109,777,184,593,961,0.8085327783558793,2023-01-10
chrome_android_110,777,184,593,961,0.8085327783558793,2023-02-07
edge_79,777,184,593,961,0.8085327783558793,2020-01-15
chrome_73,777,184,593,961,0.8085327783558793,2019-03-12
firefox_107,775,183,592,958,0.8089770354906054,2022-11-15
firefox_133,775,183,592,958,0.8089770354906054,2024-11-26
firefox_134,775,183,592,958,0.8089770354906054,2025-01-07
firefox_135,775,183,592,958,0.8089770354906054,2025-02-04
firefox_136,775,183,592,958,0.8089770354906054,2025-03-04
chrome_android_72,776,184,592,960,0.8083333333333333,2019-01-29
chrome_android_74,776,184,592,960,0.8083333333333333,2019-04-24
edge_89,777,185,592,962,0.8076923076923077,2021-03-04
edge_108,777,185,592,962,0.8076923076923077,2022-12-05
chrome_93,777,185,592,962,0.8076923076923077,2021-08-31
chrome_71,776,185,591,961,0.8074921956295525,2018-12-04
firefox_105,774,184,590,958,0.8079331941544885,2022-09-20
firefox_106,774,184,590,958,0.8079331941544885,2022-10-18
firefox_113,774,184,590,958,0.8079331941544885,2023-05-09
firefox_125,774,184,590,958,0.8079331941544885,2024-04-16
safari_ios_15.1.0,776,186,590,962,0.8066528066528067,2021-10-25
edge_93,776,186,590,962,0.8066528066528067,2021-09-02
chrome_80,776,186,590,962,0.8066528066528067,2020-02-04
chrome_81,776,186,590,962,0.8066528066528067,2020-04-07
webview_android_108,775,186,589,961,0.8064516129032258,2022-11-29
opera_70,775,186,589,961,0.8064516129032258,2020-07-27
opera_71,775,186,589,961,0.8064516129032258,2020-09-15
opera_95,775,186,589,961,0.8064516129032258,2023-02-01
opera_96,775,186,589,961,0.8064516129032258,2023-02-22
chrome_android_108,775,186,589,961,0.8064516129032258,2022-11-29
chrome_69,775,186,589,961,0.8064516129032258,2018-09-04
webview_ios_14.5.0,768,179,589,947,0.8109820485744457,2021-04-26
firefox_android_100,773,185,588,958,0.8068893528183716,2022-05-03
firefox_android_101,773,185,588,958,0.8068893528183716,2022-05-31
opera_60,774,186,588,960,0.80625,2019-04-09
firefox_121,773,185,588,958,0.8068893528183716,2023-12-19
safari_ios_15,775,187,588,962,0.8056133056133056,2021-09-20
chrome_android_71,774,186,588,960,0.80625,2018-12-04
chrome_android_73,774,186,588,960,0.80625,2019-03-12
chrome_89,775,187,588,962,0.8056133056133056,2021-03-02
chrome_105,775,187,588,962,0.8056133056133056,2022-09-02
chrome_106,775,187,588,962,0.8056133056133056,2022-09-27
chrome_107,775,187,588,962,0.8056133056133056,2022-10-25
webview_android_87,774,187,587,961,0.8054110301768991,2020-11-17
webview_android_88,774,187,587,961,0.8054110301768991,2021-01-19
webview_android_90,774,187,587,961,0.8054110301768991,2021-04-13
webview_android_91,774,187,587,961,0.8054110301768991,2021-05-25
webview_android_92,774,187,587,961,0.8054110301768991,2021-07-20
opera_73,774,187,587,961,0.8054110301768991,2020-12-09
opera_74,774,187,587,961,0.8054110301768991,2021-02-02
opera_76,774,187,587,961,0.8054110301768991,2021-04-28
opera_77,774,187,587,961,0.8054110301768991,2021-06-09
opera_78,774,187,587,961,0.8054110301768991,2021-08-03
opera_94,774,187,587,961,0.8054110301768991,2022-12-15
chrome_66,774,187,587,961,0.8054110301768991,2018-04-17
chrome_70,774,187,587,961,0.8054110301768991,2018-10-16
chrome_79,774,187,587,961,0.8054110301768991,2019-12-10
firefox_android_102,772,186,586,958,0.8058455114822547,2022-06-28
firefox_android_103,772,186,586,958,0.8058455114822547,2022-07-26
firefox_android_104,772,186,586,958,0.8058455114822547,2022-08-23
opera_58,773,187,586,960,0.8052083333333333,2019-01-23
opera_android_77,773,187,586,960,0.8052083333333333,2023-08-31
opera_android_78,773,187,586,960,0.8052083333333333,2023-10-23
firefox_120,772,186,586,958,0.8058455114822547,2023-11-21
firefox_122,772,186,586,958,0.8058455114822547,2024-01-23
firefox_123,772,186,586,958,0.8058455114822547,2024-02-20
firefox_124,772,186,586,958,0.8058455114822547,2024-03-19
chrome_android_66,773,187,586,960,0.8052083333333333,2018-04-17
chrome_android_69,773,187,586,960,0.8052083333333333,2018-09-04
edge_83,774,188,586,962,0.8045738045738046,2020-05-21
edge_105,774,188,586,962,0.8045738045738046,2022-09-01
edge_106,774,188,586,962,0.8045738045738046,2022-10-03
edge_107,774,188,586,962,0.8045738045738046,2022-10-27
chrome_94,774,188,586,962,0.8045738045738046,2021-09-21
chrome_95,774,188,586,962,0.8045738045738046,2021-10-19
chrome_96,774,188,586,962,0.8045738045738046,2021-11-15
webview_android_80,773,188,585,961,0.8043704474505723,2020-02-04
webview_android_81,773,188,585,961,0.8043704474505723,2020-04-07
webview_android_93,773,188,585,961,0.8043704474505723,2021-08-31
opera_79,773,188,585,961,0.8043704474505723,2021-09-14
chrome_android_87,773,188,585,961,0.8043704474505723,2020-11-17
chrome_android_88,773,188,585,961,0.8043704474505723,2021-01-19
chrome_android_90,773,188,585,961,0.8043704474505723,2021-04-13
chrome_android_91,773,188,585,961,0.8043704474505723,2021-05-25
chrome_android_92,773,188,585,961,0.8043704474505723,2021-07-20
firefox_100,771,187,584,958,0.8048016701461378,2022-05-03
firefox_101,771,187,584,958,0.8048016701461378,2022-05-31
firefox_111,771,187,584,958,0.8048016701461378,2023-03-14
firefox_112,771,187,584,958,0.8048016701461378,2023-04-11
chrome_android_70,772,188,584,960,0.8041666666666667,2018-10-17
edge_94,773,189,584,962,0.8035343035343036,2021-09-24
edge_95,773,189,584,962,0.8035343035343036,2021-10-21
edge_96,773,189,584,962,0.8035343035343036,2021-11-19
webview_android_105,772,189,583,961,0.8033298647242456,2022-09-02
webview_android_106,772,189,583,961,0.8033298647242456,2022-09-27
webview_android_107,772,189,583,961,0.8033298647242456,2022-10-25
chrome_android_80,772,189,583,961,0.8033298647242456,2020-02-04
chrome_android_81,772,189,583,961,0.8033298647242456,2020-04-07
chrome_android_93,772,189,583,961,0.8033298647242456,2021-08-31
chrome_android_105,772,189,583,961,0.8033298647242456,2022-09-02
chrome_android_106,772,189,583,961,0.8033298647242456,2022-09-27
chrome_android_107,772,189,583,961,0.8033298647242456,2022-10-25
firefox_android_99,770,188,582,958,0.8037578288100209,2022-04-05
webview_android_77,771,189,582,960,0.803125,2019-09-10
webview_android_78,771,189,582,960,0.803125,2019-10-22
webview_android_79,771,189,582,960,0.803125,2019-12-17
firefox_102,770,188,582,958,0.8037578288100209,2022-06-28
firefox_103,770,188,582,958,0.8037578288100209,2022-07-26
firefox_104,770,188,582,958,0.8037578288100209,2022-08-23
firefox_114,770,188,582,958,0.8037578288100209,2023-06-06
firefox_115,770,188,582,958,0.8037578288100209,2023-07-04
firefox_118,770,188,582,958,0.8037578288100209,2023-09-26
firefox_119,770,188,582,958,0.8037578288100209,2023-10-24
chrome_83,772,190,582,962,0.8024948024948025,2020-05-19
chrome_99,772,190,582,962,0.8024948024948025,2022-03-01
chrome_100,772,190,582,962,0.8024948024948025,2022-03-29
webview_android_89,771,190,581,961,0.8022892819979188,2021-03-02
opera_67,771,190,581,961,0.8022892819979188,2020-03-03
opera_68,771,190,581,961,0.8022892819979188,2020-04-22
opera_75,771,190,581,961,0.8022892819979188,2021-03-24
opera_91,771,190,581,961,0.8022892819979188,2022-09-14
opera_92,771,190,581,961,0.8022892819979188,2022-10-19
opera_93,771,190,581,961,0.8022892819979188,2022-11-17
opera_android_86,771,190,581,961,0.8022892819979188,2024-12-02
opera_56,770,190,580,960,0.8020833333333334,2018-09-25
opera_android_75,770,190,580,960,0.8020833333333334,2023-05-17
firefox_110,769,189,580,958,0.802713987473904,2023-02-14
firefox_117,769,189,580,958,0.802713987473904,2023-08-29
chrome_android_79,770,190,580,960,0.8020833333333334,2019-12-17
edge_99,771,191,580,962,0.8014553014553014,2022-03-03
edge_100,771,191,580,962,0.8014553014553014,2022-04-01
webview_android_94,770,191,579,961,0.8012486992715921,2021-09-21
webview_android_95,770,191,579,961,0.8012486992715921,2021-10-19
webview_android_96,770,191,579,961,0.8012486992715921,2021-11-15
opera_80,770,191,579,961,0.8012486992715921,2021-10-05
opera_81,770,191,579,961,0.8012486992715921,2021-11-04
opera_82,770,191,579,961,0.8012486992715921,2021-12-02
chrome_android_89,770,191,579,961,0.8012486992715921,2021-03-02
firefox_android_98,768,190,578,958,0.8016701461377871,2022-03-08
opera_57,769,191,578,960,0.8010416666666667,2018-11-28
opera_66,769,191,578,960,0.8010416666666667,2020-01-07
opera_android_76,769,191,578,960,0.8010416666666667,2023-06-26
firefox_99,768,190,578,958,0.8016701461377871,2022-04-05
firefox_108,768,190,578,958,0.8016701461377871,2022-12-13
firefox_109,768,190,578,958,0.8016701461377871,2023-01-17
firefox_116,768,190,578,958,0.8016701461377871,2023-08-01
chrome_97,770,192,578,962,0.8004158004158004,2022-01-04
chrome_98,770,192,578,962,0.8004158004158004,2022-02-01
chrome_101,770,192,578,962,0.8004158004158004,2022-04-26
webview_android_83,769,192,577,961,0.8002081165452654,2020-05-19
opera_android_84,769,192,577,961,0.8002081165452654,2024-08-26
opera_android_85,769,192,577,961,0.8002081165452654,2024-10-29
chrome_android_94,769,192,577,961,0.8002081165452654,2021-09-21
chrome_android_95,769,192,577,961,0.8002081165452654,2021-10-19
chrome_android_96,769,192,577,961,0.8002081165452654,2021-11-15
chrome_68,769,192,577,961,0.8002081165452654,2018-07-24
webview_android_75,768,192,576,960,0.8,2019-06-04
opera_53,768,192,576,960,0.8,2018-05-10
firefox_98,767,191,576,958,0.8006263048016702,2022-03-08
safari_ios_14.5.0,769,193,576,962,0.7993762993762994,2021-04-26
chrome_android_68,768,192,576,960,0.8,2018-07-24
edge_97,769,193,576,962,0.7993762993762994,2022-01-06
edge_98,769,193,576,962,0.7993762993762994,2022-02-03
edge_101,769,193,576,962,0.7993762993762994,2022-04-28
chrome_102,769,193,576,962,0.7993762993762994,2022-05-24
chrome_103,769,193,576,962,0.7993762993762994,2022-06-21
chrome_104,769,193,576,962,0.7993762993762994,2022-08-02
webview_android_99,768,193,575,961,0.7991675338189386,2022-03-01
webview_android_100,768,193,575,961,0.7991675338189386,2022-03-29
opera_85,768,193,575,961,0.7991675338189386,2022-03-23
opera_86,768,193,575,961,0.7991675338189386,2022-04-20
chrome_android_83,768,193,575,961,0.7991675338189386,2020-05-19
chrome_67,768,193,575,961,0.7991675338189386,2018-05-29
webview_android_76,767,193,574,960,0.7989583333333333,2019-07-30
safari_14.1.0,768,194,574,962,0.7983367983367984,2021-04-26
opera_android_72,767,193,574,960,0.7989583333333333,2022-10-21
opera_android_74,767,193,574,960,0.7989583333333333,2023-03-13
chrome_android_67,767,193,574,960,0.7989583333333333,2018-05-31
edge_102,768,194,574,962,0.7983367983367984,2022-05-31
edge_103,768,194,574,962,0.7983367983367984,2022-06-23
edge_104,768,194,574,962,0.7983367983367984,2022-08-05
opera_69,767,194,573,961,0.7981269510926119,2020-06-24
chrome_android_99,767,194,573,961,0.7981269510926119,2022-03-01
chrome_android_100,767,194,573,961,0.7981269510926119,2022-03-29
firefox_android_97,765,193,572,958,0.7985386221294363,2022-02-08
webview_android_72,766,194,572,960,0.7979166666666667,2019-01-29
webview_android_74,766,194,572,960,0.7979166666666667,2019-04-24
opera_android_71,766,194,572,960,0.7979166666666667,2022-09-16
webview_android_97,766,195,571,961,0.7970863683662851,2022-01-04
webview_android_98,766,195,571,961,0.7970863683662851,2022-02-01
webview_android_101,766,195,571,961,0.7970863683662851,2022-04-26
webview_android_102,766,195,571,961,0.7970863683662851,2022-05-24
webview_android_103,766,195,571,961,0.7970863683662851,2022-06-21
webview_android_104,766,195,571,961,0.7970863683662851,2022-08-02
opera_83,766,195,571,961,0.7970863683662851,2022-01-19
opera_84,766,195,571,961,0.7970863683662851,2022-02-16
opera_87,766,195,571,961,0.7970863683662851,2022-05-17
opera_android_69,765,195,570,960,0.796875,2022-05-09
opera_android_73,765,195,570,960,0.796875,2023-01-17
firefox_97,764,194,570,958,0.7974947807933194,2022-02-08
opera_88,765,196,569,961,0.7960457856399584,2022-06-08
opera_89,765,196,569,961,0.7960457856399584,2022-07-07
opera_90,765,196,569,961,0.7960457856399584,2022-08-18
chrome_android_97,765,196,569,961,0.7960457856399584,2022-01-04
chrome_android_98,765,196,569,961,0.7960457856399584,2022-02-01
chrome_android_101,765,196,569,961,0.7960457856399584,2022-04-26
chrome_android_102,765,196,569,961,0.7960457856399584,2022-05-24
chrome_android_103,765,196,569,961,0.7960457856399584,2022-06-21
chrome_android_104,765,196,569,961,0.7960457856399584,2022-08-02
firefox_android_96,763,195,568,958,0.7964509394572025,2022-01-11
webview_android_71,764,196,568,960,0.7958333333333333,2018-12-04
webview_android_73,764,196,568,960,0.7958333333333333,2019-03-12
opera_55,764,196,568,960,0.7958333333333333,2018-08-16
opera_android_66,764,196,568,960,0.7958333333333333,2021-12-15
opera_android_70,764,196,568,960,0.7958333333333333,2022-06-29
opera_android_80,764,197,567,961,0.7950052029136316,2024-01-25
opera_android_81,764,197,567,961,0.7950052029136316,2024-03-14
opera_android_82,764,197,567,961,0.7950052029136316,2024-05-02
firefox_android_84,762,196,566,958,0.7954070981210856,2020-12-15
firefox_android_85,762,196,566,958,0.7954070981210856,2021-01-26
firefox_android_86,762,196,566,958,0.7954070981210856,2021-02-23
firefox_android_87,762,196,566,958,0.7954070981210856,2021-03-23
firefox_android_88,762,196,566,958,0.7954070981210856,2021-04-19
webview_android_66,763,197,566,960,0.7947916666666667,2017-04-17
webview_android_69,763,197,566,960,0.7947916666666667,2018-09-04
opera_54,763,197,566,960,0.7947916666666667,2018-06-28
firefox_96,762,196,566,958,0.7954070981210856,2022-01-11
firefox_android_82,761,197,564,958,0.7943632567849687,2020-10-20
firefox_android_83,761,197,564,958,0.7943632567849687,2020-11-17
firefox_android_93,761,197,564,958,0.7943632567849687,2021-10-05
firefox_android_94,761,197,564,958,0.7943632567849687,2021-11-02
firefox_android_95,761,197,564,958,0.7943632567849687,2021-12-07
webview_android_70,762,198,564,960,0.79375,2018-10-17
opera_android_79,762,198,564,960,0.79375,2023-12-06
webview_ios_13.4.0,755,192,563,947,0.7972544878563886,2020-03-24
firefox_android_89,760,198,562,958,0.7933194154488518,2021-06-01
firefox_android_90,760,198,562,958,0.7933194154488518,2021-07-13
firefox_android_91,760,198,562,958,0.7933194154488518,2021-08-10
firefox_android_92,760,198,562,958,0.7933194154488518,2021-09-07
firefox_84,760,198,562,958,0.7933194154488518,2020-12-15
firefox_85,760,198,562,958,0.7933194154488518,2021-01-26
firefox_86,760,198,562,958,0.7933194154488518,2021-02-23
firefox_87,760,198,562,958,0.7933194154488518,2021-03-23
firefox_88,760,198,562,958,0.7933194154488518,2021-04-19
firefox_93,760,198,562,958,0.7933194154488518,2021-10-05
firefox_94,760,198,562,958,0.7933194154488518,2021-11-02
firefox_95,760,198,562,958,0.7933194154488518,2021-12-07
opera_android_68,760,200,560,960,0.7916666666666666,2022-03-30
firefox_82,759,199,560,958,0.7922755741127349,2020-10-20
firefox_83,759,199,560,958,0.7922755741127349,2020-11-17
firefox_91,759,199,560,958,0.7922755741127349,2021-08-10
firefox_92,759,199,560,958,0.7922755741127349,2021-09-07
opera_android_83,760,201,559,961,0.7908428720083247,2024-06-25
webview_ios_14,753,194,559,947,0.795142555438226,2020-09-16
firefox_android_79,758,200,558,958,0.791231732776618,2020-07-28
firefox_android_80,758,200,558,958,0.791231732776618,2020-08-31
firefox_android_81,758,200,558,958,0.791231732776618,2020-09-22
opera_android_67,759,201,558,960,0.790625,2022-01-31
firefox_76,758,200,558,958,0.791231732776618,2020-05-05
firefox_77,758,200,558,958,0.791231732776618,2020-06-02
firefox_89,758,200,558,958,0.791231732776618,2021-06-01
firefox_90,758,200,558,958,0.791231732776618,2021-07-13
webview_android_68,758,202,556,960,0.7895833333333333,2018-07-24
firefox_75,757,201,556,958,0.7901878914405011,2020-04-07
webview_android_67,757,203,554,960,0.7885416666666667,2018-05-31
safari_13.1.0,758,204,554,962,0.7879417879417879,2020-03-24
firefox_78,756,202,554,958,0.7891440501043842,2020-06-30
firefox_79,756,202,554,958,0.7891440501043842,2020-07-28
firefox_80,756,202,554,958,0.7891440501043842,2020-08-25
firefox_81,756,202,554,958,0.7891440501043842,2020-09-22
safari_ios_13.4.0,757,205,552,962,0.7869022869022869,2020-03-24
safari_ios_14,755,207,548,962,0.7848232848232848,2020-09-16
safari_14,754,208,546,962,0.7837837837837838,2020-09-16
firefox_74,751,207,544,958,0.7839248434237995,2020-03-10
firefox_72,750,208,542,958,0.7828810020876826,2020-01-07
firefox_73,750,208,542,958,0.7828810020876826,2020-02-11
firefox_android_65,749,208,541,957,0.7826541274817137,2019-01-29
firefox_android_66,749,208,541,957,0.7826541274817137,2019-03-19
firefox_69,749,208,541,957,0.7826541274817137,2019-09-03
firefox_70,749,208,541,957,0.7826541274817137,2019-10-22
firefox_71,748,209,539,957,0.7816091954022989,2019-12-10
firefox_android_67,747,210,537,957,0.780564263322884,2019-05-21
firefox_android_68,747,210,537,957,0.780564263322884,2019-07-09
firefox_65,747,210,537,957,0.780564263322884,2019-01-29
firefox_66,747,210,537,957,0.780564263322884,2019-03-19
webview_ios_13,741,206,535,947,0.7824709609292503,2019-09-19
firefox_android_63,745,212,533,957,0.7784743991640544,2018-10-23
firefox_android_64,745,212,533,957,0.7784743991640544,2018-12-11
firefox_67,745,212,533,957,0.7784743991640544,2019-05-21
firefox_68,744,213,531,957,0.7774294670846394,2019-07-09
firefox_63,743,214,529,957,0.7763845350052246,2018-10-23
firefox_64,743,214,529,957,0.7763845350052246,2018-12-11
webview_ios_12.2.0,737,210,527,947,0.778247096092925,2019-03-25
safari_13,744,218,526,962,0.7733887733887734,2019-09-19
safari_ios_13,743,219,524,962,0.7723492723492723,2019-09-19
chrome_64,740,221,519,961,0.7700312174817898,2018-01-23
chrome_65,740,221,519,961,0.7700312174817898,2018-03-06
safari_12.1.0,740,222,518,962,0.7692307692307693,2019-03-25
chrome_android_64,739,221,518,960,0.7697916666666667,2018-01-23
chrome_android_65,739,221,518,960,0.7697916666666667,2018-03-06
chrome_62,739,222,517,961,0.768990634755463,2017-10-17
safari_ios_12.2.0,739,223,516,962,0.7681912681912682,2019-03-25
chrome_android_62,738,222,516,960,0.76875,2017-10-24
chrome_63,738,223,515,961,0.7679500520291364,2017-12-06
chrome_android_63,737,223,514,960,0.7677083333333333,2017-12-05
chrome_61,737,224,513,961,0.7669094693028096,2017-09-05
chrome_android_61,736,224,512,960,0.7666666666666667,2017-09-05
firefox_android_62,734,223,511,957,0.7669801462904912,2018-09-05
opera_51,735,225,510,960,0.765625,2018-02-07
opera_52,735,225,510,960,0.765625,2018-03-22
opera_49,734,226,508,960,0.7645833333333333,2017-11-08
firefox_61,732,225,507,957,0.7648902821316614,2018-06-26
firefox_62,732,225,507,957,0.7648902821316614,2018-09-05
chrome_60,734,227,507,961,0.7637877211238293,2017-07-25
opera_50,733,227,506,960,0.7635416666666667,2018-01-04
firefox_60,731,226,505,957,0.7638453500522466,2018-05-09
webview_ios_11.3.0,726,221,505,947,0.7666314677930306,2018-03-29
opera_48,732,228,504,960,0.7625,2017-09-27
chrome_android_60,732,228,504,960,0.7625,2017-08-01
firefox_59,730,227,503,957,0.7628004179728317,2018-03-13
webview_ios_12,725,222,503,947,0.7655755015839493,2018-09-17
opera_android_64,731,229,502,960,0.7614583333333333,2021-05-25
opera_android_65,731,229,502,960,0.7614583333333333,2021-10-20
firefox_android_61,729,228,501,957,0.7617554858934169,2018-06-26
chrome_59,731,230,501,961,0.7606659729448492,2017-06-05
opera_android_62,730,230,500,960,0.7604166666666666,2021-02-16
firefox_android_60,728,229,499,957,0.7607105538140021,2018-05-09
webview_android_64,729,231,498,960,0.759375,2018-01-23
webview_android_65,729,231,498,960,0.759375,2017-03-06
opera_47,729,231,498,960,0.759375,2017-08-09
safari_11.1.0,730,232,498,962,0.7588357588357588,2018-04-12
opera_android_63,729,231,498,960,0.759375,2021-04-16
chrome_android_59,729,231,498,960,0.759375,2017-06-06
firefox_android_59,727,230,497,957,0.7596656217345873,2018-03-13
firefox_58,727,230,497,957,0.7596656217345873,2018-01-23
webview_android_62,728,232,496,960,0.7583333333333333,2017-10-24
safari_12,729,233,496,962,0.7577962577962578,2018-09-17
opera_android_61,728,232,496,960,0.7583333333333333,2020-12-07
firefox_57,726,231,495,957,0.7586206896551724,2017-11-14
chrome_58,728,233,495,961,0.7575442247658689,2017-04-19
webview_android_63,727,233,494,960,0.7572916666666667,2017-12-05
safari_ios_11.3.0,728,234,494,962,0.7567567567567568,2018-03-29
chrome_57,727,234,493,961,0.7565036420395421,2017-03-09
webview_android_61,726,234,492,960,0.75625,2017-09-05
safari_ios_12,727,235,492,962,0.7557172557172557,2018-09-17
chrome_android_58,726,234,492,960,0.75625,2017-04-25
firefox_android_58,724,233,491,957,0.7565308254963428,2018-01-22
opera_46,725,235,490,960,0.7552083333333334,2017-06-22
firefox_android_57,723,234,489,957,0.7554858934169278,2017-11-28
firefox_55,723,234,489,957,0.7554858934169278,2017-08-08
chrome_56,725,236,489,961,0.7544224765868887,2017-01-25
opera_android_60,724,236,488,960,0.7541666666666667,2020-09-23
firefox_52,722,235,487,957,0.754440961337513,2017-03-07
firefox_56,722,235,487,957,0.754440961337513,2017-09-28
opera_45,723,237,486,960,0.753125,2017-05-10
firefox_53,721,236,485,957,0.7533960292580982,2017-04-19
firefox_54,721,236,485,957,0.7533960292580982,2017-06-13
webview_android_60,722,238,484,960,0.7520833333333333,2017-08-01
opera_44,722,238,484,960,0.7520833333333333,2017-03-21
safari_11,723,239,484,962,0.7515592515592515,2017-09-19
firefox_android_55,720,237,483,957,0.7523510971786834,2017-08-08
opera_android_59,721,239,482,960,0.7510416666666667,2020-06-30
firefox_android_56,719,238,481,957,0.7513061650992685,2017-09-28
edge_16,713,232,481,945,0.7544973544973544,2017-10-17
opera_43,720,240,480,960,0.75,2017-02-07
firefox_android_52,718,239,479,957,0.7502612330198537,2017-03-07
firefox_51,718,239,479,957,0.7502612330198537,2017-01-24
webview_ios_11,713,234,479,947,0.7529039070749736,2017-09-19
webview_android_59,719,241,478,960,0.7489583333333333,2017-06-06
opera_android_58,719,241,478,960,0.7489583333333333,2020-05-13
safari_ios_11,720,242,478,962,0.7484407484407485,2017-09-19
chrome_android_57,719,241,478,960,0.7489583333333333,2017-03-16
firefox_android_53,717,240,477,957,0.7492163009404389,2017-04-19
firefox_android_54,717,240,477,957,0.7492163009404389,2017-06-13
chrome_55,717,244,473,961,0.7460978147762747,2016-12-01
webview_android_58,716,244,472,960,0.7458333333333333,2017-04-25
chrome_android_56,716,244,472,960,0.7458333333333333,2017-02-01
firefox_android_51,714,243,471,957,0.7460815047021944,2017-01-24
firefox_50,714,243,471,957,0.7460815047021944,2016-11-15
chrome_54,716,245,471,961,0.745057232049948,2016-10-12
chrome_53,714,247,467,961,0.7429760665972945,2016-08-31
chrome_android_55,713,247,466,960,0.7427083333333333,2016-12-06
firefox_android_50,711,246,465,957,0.7429467084639498,2016-11-15
edge_15,705,240,465,945,0.746031746031746,2017-04-05
opera_42,712,248,464,960,0.7416666666666667,2016-12-13
opera_android_57,712,248,464,960,0.7416666666666667,2020-03-30
chrome_android_54,712,248,464,960,0.7416666666666667,2016-10-19
firefox_49,710,247,463,957,0.741901776384535,2016-09-20
edge_18,709,246,463,955,0.7424083769633508,2018-10-02
opera_41,711,249,462,960,0.740625,2016-10-25
firefox_43,709,248,461,957,0.7408568443051202,2015-12-15
chrome_android_53,710,250,460,960,0.7395833333333334,2016-09-07
firefox_android_43,708,249,459,957,0.7398119122257053,2015-12-15
chrome_52,710,251,459,961,0.7388137356919875,2016-07-20
webview_android_57,709,251,458,960,0.7385416666666667,2017-03-16
opera_40,709,251,458,960,0.7385416666666667,2016-09-20
opera_android_56,709,251,458,960,0.7385416666666667,2020-02-06
firefox_android_49,707,250,457,957,0.7387669801462905,2016-09-20
firefox_42,707,250,457,957,0.7387669801462905,2015-11-03
edge_14,701,244,457,945,0.7417989417989418,2016-08-02
webview_android_56,708,252,456,960,0.7375,2017-02-01
firefox_android_42,706,251,455,957,0.7377220480668757,2015-11-03
firefox_android_46,706,251,455,957,0.7377220480668757,2016-04-26
firefox_android_47,706,251,455,957,0.7377220480668757,2016-06-07
firefox_41,705,252,453,957,0.7366771159874608,2015-09-22
chrome_49,707,254,453,961,0.7356919875130072,2016-03-02
chrome_50,707,254,453,961,0.7356919875130072,2016-04-13
webview_android_55,706,254,452,960,0.7354166666666667,2016-12-06
opera_android_55,706,254,452,960,0.7354166666666667,2019-12-03
chrome_android_52,706,254,452,960,0.7354166666666667,2016-07-27
firefox_android_41,704,253,451,957,0.735632183908046,2015-09-22
chrome_51,706,255,451,961,0.7346514047866806,2016-05-25
webview_android_54,705,255,450,960,0.734375,2016-10-19
opera_39,705,255,450,960,0.734375,2016-08-02
opera_android_54,705,255,450,960,0.734375,2019-10-18
firefox_android_45,703,254,449,957,0.7345872518286312,2016-03-08
chrome_47,705,256,449,961,0.7336108220603538,2015-12-01
chrome_48,705,256,449,961,0.7336108220603538,2016-01-20
opera_36,704,256,448,960,0.7333333333333333,2016-03-15
opera_android_53,704,256,448,960,0.7333333333333333,2019-07-11
firefox_android_44,702,255,447,957,0.7335423197492164,2016-01-26
firefox_android_48,702,255,447,957,0.7335423197492164,2016-08-02
edge_17,696,249,447,945,0.7365079365079366,2018-04-30
chrome_42,704,257,447,961,0.7325702393340271,2015-04-14
chrome_android_49,703,257,446,960,0.7322916666666667,2016-03-09
chrome_android_50,703,257,446,960,0.7322916666666667,2016-04-13
firefox_39,701,256,445,957,0.7324973876698014,2015-07-02
firefox_40,701,256,445,957,0.7324973876698014,2015-08-11
firefox_46,701,256,445,957,0.7324973876698014,2016-04-26
chrome_39,703,258,445,961,0.7315296566077003,2014-11-18
chrome_46,703,258,445,961,0.7315296566077003,2015-10-13
webview_android_53,702,258,444,960,0.73125,2016-09-07
opera_37,702,258,444,960,0.73125,2016-05-04
chrome_android_51,702,258,444,960,0.73125,2016-06-08
firefox_android_39,700,257,443,957,0.7314524555903866,2015-07-02
firefox_android_40,700,257,443,957,0.7314524555903866,2015-08-11
firefox_48,700,257,443,957,0.7314524555903866,2016-08-02
chrome_38,702,259,443,961,0.7304890738813735,2014-10-07
chrome_41,702,259,443,961,0.7304890738813735,2015-03-03
chrome_45,702,259,443,961,0.7304890738813735,2015-09-01
opera_29,701,259,442,960,0.7302083333333333,2015-04-28
opera_33,701,259,442,960,0.7302083333333333,2015-10-27
opera_38,701,259,442,960,0.7302083333333333,2016-06-08
safari_10.1.0,702,260,442,962,0.7297297297297297,2017-03-27
opera_android_52,701,259,442,960,0.7302083333333333,2019-05-17
chrome_android_47,701,259,442,960,0.7302083333333333,2015-12-02
chrome_android_48,701,259,442,960,0.7302083333333333,2016-01-26
firefox_47,699,258,441,957,0.7304075235109718,2016-06-07
edge_13,693,252,441,945,0.7333333333333333,2015-11-12
opera_32,700,260,440,960,0.7291666666666666,2015-09-15
opera_34,700,260,440,960,0.7291666666666666,2015-12-08
opera_35,700,260,440,960,0.7291666666666666,2016-02-02
chrome_android_42,700,260,440,960,0.7291666666666666,2015-04-15
firefox_38,698,259,439,957,0.7293625914315569,2015-05-12
firefox_44,698,259,439,957,0.7293625914315569,2016-01-26
firefox_45,698,259,439,957,0.7293625914315569,2016-03-08
chrome_37,700,261,439,961,0.72840790842872,2014-08-26
chrome_43,700,261,439,961,0.72840790842872,2015-05-19
chrome_44,700,261,439,961,0.72840790842872,2015-07-21
safari_ios_10.3.0,700,262,438,962,0.7276507276507277,2017-03-27
chrome_android_39,699,261,438,960,0.728125,2014-11-12
chrome_android_46,699,261,438,960,0.728125,2015-10-14
firefox_android_38,697,260,437,957,0.7283176593521421,2015-05-12
chrome_40,699,262,437,961,0.7273673257023934,2015-01-21
webview_android_52,698,262,436,960,0.7270833333333333,2016-07-27
opera_30,698,262,436,960,0.7270833333333333,2015-06-09
opera_31,698,262,436,960,0.7270833333333333,2015-08-04
opera_android_50,698,262,436,960,0.7270833333333333,2019-02-18
chrome_android_38,698,262,436,960,0.7270833333333333,2014-10-08
chrome_android_41,698,262,436,960,0.7270833333333333,2015-03-11
chrome_android_45,698,262,436,960,0.7270833333333333,2015-09-01
opera_28,697,263,434,960,0.7260416666666667,2015-03-10
opera_android_49,697,263,434,960,0.7260416666666667,2018-12-07
opera_android_51,697,263,434,960,0.7260416666666667,2019-03-21
chrome_android_37,697,263,434,960,0.7260416666666667,2014-09-03
webview_ios_10.3.0,690,257,433,947,0.7286166842661035,2017-03-27
opera_26,696,264,432,960,0.725,2014-12-03
chrome_android_43,696,264,432,960,0.725,2015-05-27
chrome_android_44,696,264,432,960,0.725,2015-07-29
chrome_35,696,265,431,961,0.7242455775234131,2014-05-20
chrome_36,696,265,431,961,0.7242455775234131,2014-07-16
webview_android_49,695,265,430,960,0.7239583333333334,2016-03-09
webview_android_50,695,265,430,960,0.7239583333333334,2016-04-13
opera_25,695,265,430,960,0.7239583333333334,2014-10-15
opera_android_42,695,265,430,960,0.7239583333333334,2017-01-21
opera_android_46,695,265,430,960,0.7239583333333334,2018-05-14
opera_android_48,695,265,430,960,0.7239583333333334,2018-11-08
chrome_android_40,695,265,430,960,0.7239583333333334,2015-01-21
chrome_33,695,266,429,961,0.7232049947970863,2014-02-20
chrome_34,695,266,429,961,0.7232049947970863,2014-04-08
webview_android_51,694,266,428,960,0.7229166666666667,2016-06-08
opera_27,694,266,428,960,0.7229166666666667,2015-01-27
opera_android_45,694,266,428,960,0.7229166666666667,2018-02-15
opera_android_47,694,266,428,960,0.7229166666666667,2018-07-23
webview_android_47,693,267,426,960,0.721875,2015-12-02
webview_android_48,693,267,426,960,0.721875,2016-01-26
opera_24,693,267,426,960,0.721875,2014-09-02
chrome_android_36,693,267,426,960,0.721875,2014-07-16
opera_android_44,692,268,424,960,0.7208333333333333,2017-12-11
chrome_android_35,692,268,424,960,0.7208333333333333,2014-05-20
webview_android_46,691,269,422,960,0.7197916666666667,2015-10-14
opera_22,691,269,422,960,0.7197916666666667,2014-06-03
opera_23,691,269,422,960,0.7197916666666667,2014-07-22
opera_android_41,691,269,422,960,0.7197916666666667,2016-10-25
opera_android_43,691,269,422,960,0.7197916666666667,2017-09-27
chrome_android_33,691,269,422,960,0.7197916666666667,2014-02-26
chrome_android_34,691,269,422,960,0.7197916666666667,2014-04-02
webview_android_45,690,270,420,960,0.71875,2015-09-01
opera_21,690,270,420,960,0.71875,2014-05-06
webview_android_39,689,271,418,960,0.7177083333333333,2014-11-12
webview_android_42,689,271,418,960,0.7177083333333333,2015-04-15
chrome_30,689,272,417,961,0.7169614984391259,2013-10-01
webview_android_38,688,272,416,960,0.7166666666666667,2014-10-08
webview_android_41,688,272,416,960,0.7166666666666667,2015-03-11
webview_android_43,688,272,416,960,0.7166666666666667,2015-05-27
webview_android_44,688,272,416,960,0.7166666666666667,2015-07-29
opera_android_37,688,272,416,960,0.7166666666666667,2016-06-16
edge_12,680,265,415,945,0.7195767195767195,2015-07-29
chrome_31,688,273,415,961,0.7159209157127991,2013-11-12
chrome_32,688,273,415,961,0.7159209157127991,2014-01-14
opera_17,687,273,414,960,0.715625,2013-10-08
safari_10,688,274,414,962,0.7151767151767152,2016-09-20
chrome_28,687,274,413,961,0.7148803329864725,2013-07-09
webview_android_37,686,274,412,960,0.7145833333333333,2014-09-03
opera_18,686,274,412,960,0.7145833333333333,2013-11-19
opera_19,686,274,412,960,0.7145833333333333,2014-01-28
opera_android_36,686,274,412,960,0.7145833333333333,2016-03-31
chrome_29,686,275,411,961,0.7138397502601457,2013-08-20
webview_android_40,685,275,410,960,0.7135416666666666,2015-01-21
opera_20,685,275,410,960,0.7135416666666666,2014-03-04
chrome_android_30,685,275,410,960,0.7135416666666666,2013-10-02
chrome_27,685,276,409,961,0.7127991675338189,2013-05-21
opera_15,684,276,408,960,0.7125,2013-07-02
opera_16,684,276,408,960,0.7125,2013-08-27
chrome_android_31,684,276,408,960,0.7125,2013-11-14
chrome_android_32,684,276,408,960,0.7125,2014-01-15
firefox_35,682,275,407,957,0.7126436781609196,2015-01-13
firefox_37,682,275,407,957,0.7126436781609196,2015-03-31
chrome_26,684,277,407,961,0.7117585848074922,2013-03-26
opera_android_30,683,277,406,960,0.7114583333333333,2015-06-10
opera_android_35,683,277,406,960,0.7114583333333333,2016-02-04
chrome_android_28,683,277,406,960,0.7114583333333333,2013-07-10
firefox_android_37,681,276,405,957,0.7115987460815048,2015-03-31
firefox_34,681,276,405,957,0.7115987460815048,2014-12-01
firefox_36,681,276,405,957,0.7115987460815048,2015-02-24
opera_android_32,682,278,404,960,0.7104166666666667,2015-09-23
opera_android_33,682,278,404,960,0.7104166666666667,2015-11-03
opera_android_34,682,278,404,960,0.7104166666666667,2015-12-16
chrome_android_27,682,278,404,960,0.7104166666666667,2013-05-22
chrome_android_29,682,278,404,960,0.7104166666666667,2013-08-21
firefox_android_35,680,277,403,957,0.7105538140020898,2015-01-13
firefox_android_36,680,277,403,957,0.7105538140020898,2015-02-27
chrome_android_26,681,279,402,960,0.709375,2013-04-03
firefox_android_34,679,278,401,957,0.709508881922675,2014-12-01
opera_android_27,680,280,400,960,0.7083333333333334,2015-01-29
opera_android_28,680,280,400,960,0.7083333333333334,2015-03-10
opera_android_26,679,281,398,960,0.7072916666666667,2014-12-02
opera_android_29,679,281,398,960,0.7072916666666667,2015-04-28
safari_ios_10,680,282,398,962,0.7068607068607069,2016-09-13
firefox_33,677,280,397,957,0.7074190177638453,2014-10-14
chrome_25,678,283,395,961,0.7055150884495317,2013-02-21
safari_9.1.0,678,284,394,962,0.7047817047817048,2016-03-21
firefox_android_33,675,282,393,957,0.7053291536050157,2014-10-14
webview_ios_10,670,277,393,947,0.7074973600844773,2016-09-13
chrome_24,676,285,391,961,0.7034339229968782,2013-01-10
safari_7,676,286,390,962,0.7027027027027027,2013-10-22
chrome_android_25,675,285,390,960,0.703125,2013-02-27
firefox_32,673,284,389,957,0.703239289446186,2014-09-02
chrome_23,675,286,389,961,0.7023933402705516,2012-11-06
safari_8,675,287,388,962,0.7016632016632016,2014-10-16
safari_9,675,287,388,962,0.7016632016632016,2015-09-30
firefox_android_32,672,285,387,957,0.7021943573667712,2014-09-02
opera_android_24,673,287,386,960,0.7010416666666667,2014-09-10
opera_android_25,673,287,386,960,0.7010416666666667,2014-10-16
firefox_31,671,286,385,957,0.7011494252873564,2014-07-22
samsunginternet_android_27,672,288,384,960,0.7,2024-11-06
samsunginternet_android_26,671,289,382,960,0.6989583333333333,2024-06-07
opera_android_22,671,289,382,960,0.6989583333333333,2014-06-17
opera_android_21,670,290,380,960,0.6979166666666666,2014-04-22
safari_ios_9.3.0,670,292,378,962,0.6964656964656964,2016-03-21
firefox_android_31,667,290,377,957,0.696969696969697,2014-07-22
webview_ios_9.3.0,660,287,373,947,0.6969376979936642,2016-03-21
opera_android_20,666,294,372,960,0.69375,2014-03-06
safari_ios_9,667,295,372,962,0.6933471933471933,2015-09-16
samsunginternet_android_25,665,295,370,960,0.6927083333333334,2024-04-24
safari_ios_8,666,296,370,962,0.6923076923076923,2014-09-17
opera_android_19,664,296,368,960,0.6916666666666667,2014-01-28
webview_ios_9,657,290,367,947,0.6937697993664202,2015-09-16
opera_android_18,663,297,366,960,0.690625,2013-11-20
webview_ios_8,656,291,365,947,0.6927138331573389,2014-09-17
opera_android_16,662,298,364,960,0.6895833333333333,2013-09-18
chrome_22,662,299,363,961,0.6888657648283039,2012-09-25
chrome_21,661,300,361,961,0.6878251821019771,2012-07-31
safari_6,661,301,360,962,0.6871101871101871,2012-07-25
opera_android_15,659,301,358,960,0.6864583333333333,2013-07-08
firefox_29,656,301,355,957,0.6854754440961337,2014-04-29
firefox_30,656,301,355,957,0.6854754440961337,2014-06-10
firefox_27,655,302,353,957,0.6844305120167189,2014-02-04
chrome_20,657,304,353,961,0.6836628511966701,2012-06-26
safari_ios_7,657,305,352,962,0.682952182952183,2013-09-18
firefox_28,654,303,351,957,0.6833855799373041,2014-03-18
firefox_android_27,652,305,347,957,0.6812957157784744,2014-02-04
firefox_android_28,652,305,347,957,0.6812957157784744,2014-03-18
firefox_25,652,305,347,957,0.6812957157784744,2013-10-29
firefox_26,652,305,347,957,0.6812957157784744,2013-12-10
firefox_android_29,651,306,345,957,0.6802507836990596,2014-04-29
firefox_android_30,651,306,345,957,0.6802507836990596,2014-06-10
chrome_19,653,308,345,961,0.6795005202913632,2012-05-15
webview_ios_7,646,301,345,947,0.6821541710665259,2013-09-18
samsunginternet_android_24,652,308,344,960,0.6791666666666667,2024-01-25
opera_android_14,651,308,343,959,0.6788321167883211,2013-05-21
chrome_16,652,309,343,961,0.6784599375650364,2011-12-13
samsunginternet_android_23,651,309,342,960,0.678125,2023-10-18
firefox_android_26,649,308,341,957,0.6781609195402298,2013-12-10
chrome_18,651,310,341,961,0.6774193548387096,2012-03-28
firefox_android_25,648,309,339,957,0.677115987460815,2013-10-29
chrome_17,650,311,339,961,0.676378772112383,2012-02-08
chrome_15,648,313,335,961,0.6742976066597295,2011-10-25
samsunginternet_android_22,639,321,318,960,0.665625,2023-07-14
chrome_14,639,321,318,960,0.665625,2011-09-16
samsunginternet_android_21,638,322,316,960,0.6645833333333333,2023-05-19
chrome_android_18,638,322,316,960,0.6645833333333333,2012-06-27
samsunginternet_android_20,634,326,308,960,0.6604166666666667,2023-02-10
safari_ios_6,635,327,308,962,0.66008316008316,2012-09-10
firefox_22,631,326,305,957,0.6593521421107628,2013-06-25
firefox_23,631,326,305,957,0.6593521421107628,2013-08-06
opera_android_12.1.0,628,324,304,952,0.6596638655462185,2012-10-09
firefox_24,630,327,303,957,0.658307210031348,2013-09-17
webview_ios_6,624,323,301,947,0.6589229144667371,2012-09-10
samsunginternet_android_19,630,330,300,960,0.65625,2022-11-01
samsunginternet_android_19.1.0,630,330,300,960,0.65625,2022-11-08
samsunginternet_android_16,629,331,298,960,0.6552083333333333,2021-11-25
samsunginternet_android_16.2.0,629,331,298,960,0.6552083333333333,2022-03-06
firefox_android_24,627,330,297,957,0.6551724137931034,2013-09-17
samsunginternet_android_18,628,332,296,960,0.6541666666666667,2022-08-08
samsunginternet_android_18.1.0,628,332,296,960,0.6541666666666667,2022-09-09
samsunginternet_android_17,627,333,294,960,0.653125,2022-05-04
firefox_android_22,625,332,293,957,0.6530825496342738,2013-06-25
firefox_android_23,625,332,293,957,0.6530825496342738,2013-08-06
samsunginternet_android_15,625,335,290,960,0.6510416666666666,2021-08-13
chrome_13,624,336,288,960,0.65,2011-08-02
chrome_12,623,337,286,960,0.6489583333333333,2011-06-07
firefox_21,621,336,285,957,0.6489028213166145,2013-05-14
firefox_android_21,618,339,279,957,0.64576802507837,2013-05-14
ie_11,619,340,279,959,0.6454640250260688,2013-10-17
firefox_20,618,339,279,957,0.64576802507837,2013-04-02
firefox_19,617,340,277,957,0.644723092998955,2013-02-19
chrome_11,618,342,276,960,0.64375,2011-04-27
firefox_18,616,341,275,957,0.6436781609195402,2013-01-08
firefox_android_20,615,342,273,957,0.6426332288401254,2013-04-02
samsunginternet_android_14,616,343,273,959,0.6423357664233577,2021-04-17
samsunginternet_android_14.2.0,616,343,273,959,0.6423357664233577,2021-06-25
firefox_17,615,342,273,957,0.6426332288401254,2012-11-20
chrome_10,616,344,272,960,0.6416666666666667,2011-03-08
firefox_android_19,614,343,271,957,0.6415882967607106,2013-02-19
firefox_android_18,613,344,269,957,0.6405433646812957,2013-01-08
firefox_16,613,344,269,957,0.6405433646812957,2012-10-09
firefox_android_17,612,345,267,957,0.6394984326018809,2012-11-20
firefox_android_16,610,347,263,957,0.6374085684430512,2012-10-09
samsunginternet_android_8,608,351,257,959,0.6339937434827946,2018-07-18
samsunginternet_android_8.2.0,608,351,257,959,0.6339937434827946,2018-12-21
chrome_8,608,352,256,960,0.6333333333333333,2010-12-02
samsunginternet_android_11,606,353,253,959,0.6319082377476538,2019-12-05
chrome_9,606,354,252,960,0.63125,2011-02-03
samsunginternet_android_7,605,354,251,959,0.6308654848800834,2018-03-16
samsunginternet_android_10,605,354,251,959,0.6308654848800834,2019-08-22
samsunginternet_android_10.2.0,605,354,251,959,0.6308654848800834,2019-10-09
firefox_15,603,354,249,957,0.6300940438871473,2012-08-28
samsunginternet_android_6,603,356,247,959,0.6287799791449427,2017-08-23
samsunginternet_android_6.2.0,603,356,247,959,0.6287799791449427,2017-10-26
samsunginternet_android_6.4.0,603,356,247,959,0.6287799791449427,2018-02-19
samsunginternet_android_9,603,356,247,959,0.6287799791449427,2018-09-15
samsunginternet_android_9.2.0,603,356,247,959,0.6287799791449427,2019-04-02
samsunginternet_android_9.4.0,603,356,247,959,0.6287799791449427,2019-07-25
firefox_13,601,356,245,957,0.6280041797283177,2012-06-05
firefox_14,601,356,245,957,0.6280041797283177,2012-07-17
firefox_android_15,600,357,243,957,0.6269592476489029,2012-08-28
samsunginternet_android_13,601,358,243,959,0.6266944734098019,2020-12-02
samsunginternet_android_13.2.0,601,358,243,959,0.6266944734098019,2021-01-20
firefox_12,600,357,243,957,0.6269592476489029,2012-04-24
samsunginternet_android_7.2.0,600,359,241,959,0.6256517205422315,2018-06-20
samsunginternet_android_7.4.0,600,359,241,959,0.6256517205422315,2018-09-12
samsunginternet_android_12,600,359,241,959,0.6256517205422315,2020-06-19
samsunginternet_android_12.1.0,600,359,241,959,0.6256517205422315,2020-07-07
firefox_11,599,358,241,957,0.625914315569488,2012-03-13
chrome_7,600,360,240,960,0.625,2010-10-19
firefox_android_14,598,359,239,957,0.6248693834900731,2012-06-26
chrome_6,597,363,234,960,0.621875,2010-09-02
firefox_10,595,362,233,957,0.6217345872518286,2012-01-31
samsunginternet_android_11.2.0,595,364,231,959,0.6204379562043796,2020-03-22
firefox_7,594,363,231,957,0.6206896551724138,2011-09-27
firefox_9,594,363,231,957,0.6206896551724138,2011-12-20
firefox_6,593,364,229,957,0.619644723092999,2011-08-16
firefox_8,593,364,229,957,0.619644723092999,2011-11-08
firefox_android_10,592,365,227,957,0.6185997910135841,2012-01-31
firefox_android_7,591,366,225,957,0.6175548589341693,2011-09-27
firefox_android_9,591,366,225,957,0.6175548589341693,2011-12-21
firefox_android_6,590,367,223,957,0.6165099268547545,2011-08-16
firefox_android_8,590,367,223,957,0.6165099268547545,2011-11-08
firefox_4,586,371,215,957,0.6123301985370951,2011-03-22
firefox_5,586,371,215,957,0.6123301985370951,2011-06-21
firefox_android_4,583,374,209,957,0.6091954022988506,2011-03-29
firefox_android_5,583,374,209,957,0.6091954022988506,2011-06-21
samsunginternet_android_5,583,376,207,959,0.607924921793535,2016-12-15
samsunginternet_android_5.2.0,583,376,207,959,0.607924921793535,2017-04-21
samsunginternet_android_5.4.0,583,376,207,959,0.607924921793535,2017-05-17
chrome_5,577,383,194,960,0.6010416666666667,2010-05-25
safari_5.1.0,574,388,186,962,0.5966735966735967,2011-07-20
safari_5,557,405,152,962,0.579002079002079,2010-06-07
firefox_3.6.0,552,405,147,957,0.5768025078369906,2010-01-21
safari_ios_5,554,408,146,962,0.5758835758835759,2011-10-12
webview_ios_5,543,404,139,947,0.573389651531151,2011-10-12
ie_10,469,333,136,802,0.5847880299251871,2012-10-26
firefox_3.5.0,546,411,135,957,0.5705329153605015,2009-06-30
samsunginternet_android_4,540,419,121,959,0.5630865484880083,2016-03-11
samsunginternet_android_4.2.0,540,419,121,959,0.5630865484880083,2016-08-02
webview_android_4.4.3,496,380,116,876,0.5662100456621004,2014-06-02
safari_ios_4,539,423,116,962,0.5602910602910602,2010-06-21
safari_ios_4.2.0,539,423,116,962,0.5602910602910602,2010-11-22
samsunginternet_android_3,535,424,111,959,0.5578727841501564,2015-04-10
samsunginternet_android_3.2.0,535,424,111,959,0.5578727841501564,2015-08-24
webview_ios_4.2.0,528,419,109,947,0.5575501583949314,2010-11-22
chrome_4,534,426,108,960,0.55625,2010-01-25
webview_ios_4,526,421,105,947,0.5554382259767687,2010-06-21
chrome_3,531,429,102,960,0.553125,2009-09-15
safari_4,527,435,92,962,0.5478170478170478,2009-06-08
firefox_3,522,435,87,957,0.5454545454545454,2008-06-17
opera_android_12,392,311,81,703,0.5576102418207681,2012-02-25
webview_android_3,478,398,80,876,0.545662100456621,2011-02-22
webview_android_4,478,398,80,876,0.545662100456621,2011-10-18
webview_android_4.4.0,478,398,80,876,0.545662100456621,2013-12-09
opera_12.1.0,510,444,66,954,0.5345911949685535,2012-11-20
chrome_2,507,453,54,960,0.528125,2009-05-21
samsunginternet_android_2,505,454,51,959,0.5265901981230449,2014-10-17
samsunginternet_android_2.1.0,505,454,51,959,0.5265901981230449,2015-01-07
opera_android_11.5.0,373,330,43,703,0.5305832147937412,2011-10-12
opera_android_11.1.0,372,331,41,703,0.5291607396870555,2011-06-30
chrome_1,494,466,28,960,0.5145833333333333,2008-12-11
samsunginternet_android_1,493,466,27,959,0.5140771637122002,2013-04-27
samsunginternet_android_1.5.0,492,467,25,959,0.5130344108446299,2013-09-25
samsunginternet_android_1.6.0,492,467,25,959,0.5130344108446299,2014-04-11
opera_android_11,364,339,25,703,0.5177809388335705,2011-03-22
ie_9,409,393,16,802,0.5099750623441397,2011-03-14
firefox_2,486,471,15,957,0.5078369905956113,2006-10-24
firefox_1.5.0,484,473,11,957,0.5057471264367817,2005-11-29
safari_ios_3.2.0,449,440,9,889,0.5050618672665916,2010-04-03
safari_3.1.0,448,440,8,888,0.5045045045045045,2008-03-18
webview_ios_3.2.0,438,438,0,876,0.5,2010-04-03
safari_ios_3,437,452,-15,889,0.4915635545556805,2009-06-17
webview_ios_3,426,450,-24,876,0.4863013698630137,2009-06-17
opera_android_10.1.0,331,372,-41,703,0.47083926031294454,2010-11-09
safari_3,419,469,-50,888,0.47184684684684686,2007-10-26
webview_android_2.2.0,402,474,-72,876,0.4589041095890411,2010-05-20
webview_android_2,401,475,-74,876,0.4577625570776256,2009-10-26
webview_android_1,397,479,-82,876,0.4531963470319635,2008-09-23
webview_android_1.5.0,397,479,-82,876,0.4531963470319635,2009-04-27
safari_ios_2,391,496,-105,887,0.44081172491544535,2008-07-11
webview_ios_2,384,490,-106,874,0.43935926773455375,2008-07-11
firefox_1,424,533,-109,957,0.4430512016718913,2004-11-09
safari_ios_1,382,505,-123,887,0.4306651634723788,2007-06-29
webview_ios_1,375,499,-124,874,0.4290617848970252,2007-06-29
opera_12,271,434,-163,705,0.3843971631205674,2012-06-14
opera_11.6.0,255,450,-195,705,0.3617021276595745,2011-12-06
opera_11.5.0,254,451,-197,705,0.36028368794326243,2011-06-28
opera_11.1.0,253,452,-199,705,0.3588652482269504,2011-04-12
opera_11,245,460,-215,705,0.3475177304964539,2010-12-16
opera_10.6.0,225,480,-255,705,0.3191489361702128,2010-07-01
ie_8,271,531,-260,802,0.33790523690773067,2009-03-19
opera_10.5.0,221,484,-263,705,0.31347517730496455,2010-03-02
ie_7,266,536,-270,802,0.3316708229426434,2006-10-18
ie_6,265,537,-272,802,0.33042394014962595,2001-08-27
opera_9,204,501,-297,705,0.28936170212765955,2006-06-20
opera_9.1.0,204,501,-297,705,0.28936170212765955,2006-12-18
opera_9.2.0,204,501,-297,705,0.28936170212765955,2007-04-11
opera_9.5.0,204,501,-297,705,0.28936170212765955,2008-06-12
opera_9.6.0,204,501,-297,705,0.28936170212765955,2008-10-08
opera_10,204,501,-297,705,0.28936170212765955,2009-09-01
opera_10.1.0,204,501,-297,705,0.28936170212765955,2009-11-23
ie_5.5.0,235,547,-312,782,0.30051150895140666,2000-07-06
safari_2,286,602,-316,888,0.32207207207207206,2005-04-29
opera_8,190,515,-325,705,0.2695035460992908,2005-04-19
opera_8.5.0,190,515,-325,705,0.2695035460992908,2005-09-20
safari_1.3.0,279,609,-330,888,0.3141891891891892,2005-04-15
safari_1.2.0,277,611,-334,888,0.3119369369369369,2004-02-02
safari_1,275,613,-338,888,0.3096846846846847,2003-06-23
safari_1.1.0,275,613,-338,888,0.3096846846846847,2003-10-24
opera_7,177,528,-351,705,0.251063829787234,2003-01-28
opera_7.1.0,177,528,-351,705,0.251063829787234,2003-04-11
opera_7.2.0,177,528,-351,705,0.251063829787234,2003-09-23
opera_7.5.0,177,528,-351,705,0.251063829787234,2004-05-12
opera_4,175,530,-355,705,0.24822695035460993,2000-06-28
opera_5,175,530,-355,705,0.24822695035460993,2000-12-06
opera_5.1.0,175,530,-355,705,0.24822695035460993,2001-04-10
opera_6,175,530,-355,705,0.24822695035460993,2001-12-18
opera_3.5.0,174,531,-357,705,0.24680851063829787,1998-11-18
opera_3.6.0,174,531,-357,705,0.24680851063829787,1999-05-06
opera_3,171,534,-363,705,0.2425531914893617,1997-12-01
opera_2,166,539,-373,705,0.23546099290780143,1996-07-14
ie_5,185,597,-412,782,0.23657289002557544,1999-03-18
ie_4,176,606,-430,782,0.22506393861892582,1997-09-30
ie_3,166,616,-450,782,0.21227621483375958,1996-08-13
ie_1,162,620,-458,782,0.2071611253196931,1995-08-16
ie_2,162,620,-458,782,0.2071611253196931,1995-11-22
